24:d3:f2:a7:b3:cd,b4:74:9f:ba:83:34,b0:89:00:74:7c:84,9c:d6:43:cb:23:c0,30:99:35:90:32:9f,44:fb:5a:d2:d0:61,d8:0d:17:db:be:92,10:10:81:ad:c4:92,f4:e3:fb:90:3a:a8,indoor
-72,-53,-68,-60,-80,-100,-96,-100,-100,1
-100,-47,-69,-55,-100,-100,-100,-100,-100,1
-68,-56,-77,-63,-81,-100,-100,-100,-100,1
-64,-62,-77,-61,-73,-100,-100,-100,-100,1
-100,-39,-57,-51,-79,-100,-96,-100,-100,1
-51,-80,-87,-82,-58,-100,-100,-100,-100,1
-46,-81,-86,-100,-71,-100,-100,-100,-100,1
-63,-77,-75,-91,-74,-100,-76,-100,-100,1
-52,-50,-70,-62,-79,-100,-88,-100,-100,1
-73,-53,-63,-55,-79,-100,-95,-100,-100,1
-44,-57,-63,-74,-79,-100,-90,-100,-100,1
-56,-79,-78,-79,-84,-100,-97,-100,-100,1
-100,-85,-85,-100,-66,-100,-92,-100,-100,1
-61,-61,-63,-83,-84,-100,-96,-100,-100,1
-59,-49,-100,-66,-84,-100,-91,-100,-100,1
-35,-72,-82,-89,-71,-100,-90,-100,-100,1
-100,-56,-65,-57,-74,-100,-100,-100,-100,1
-68,-54,-70,-62,-100,-100,-100,-100,-100,1
-72,-58,-68,-59,-65,-100,-100,-100,-100,1
-75,-68,-89,-100,-68,-100,-100,-100,-100,1
-70,-60,-73,-68,-69,-100,-100,-100,-100,1
-70,-60,-73,-68,-69,-100,-100,-100,-100,1
-81,-58,-76,-59,-100,-100,-100,-100,-100,1
-75,-47,-64,-56,-100,-100,-100,-100,-100,1
-73,-60,-72,-64,-83,-100,-97,-100,-100,1
-57,-58,-71,-66,-71,-100,-100,-100,-100,1
-57,-63,-67,-75,-80,-100,-100,-100,-100,1
-64,-59,-70,-62,-73,-100,-100,-100,-100,1
-64,-59,-70,-62,-73,-100,-100,-100,-100,1
-73,-59,-76,-62,-79,-100,-100,-100,-100,1
-73,-59,-76,-62,-79,-100,-100,-100,-100,1
-75,-58,-68,-70,-100,-100,-100,-100,-100,1
-100,-51,-61,-55,-76,-100,-100,-100,-100,1
-100,-41,-55,-57,-76,-100,-92,-100,-100,1
-64,-36,-70,-63,-100,-100,-100,-100,-100,1
-73,-37,-68,-61,-77,-100,-100,-100,-100,1
-100,-50,-67,-62,-77,-100,-100,-100,-100,1
-49,-76,-78,-80,-80,-100,-100,-100,-100,1
-54,-77,-88,-87,-60,-100,-100,-100,-100,1
-57,-81,-89,-81,-58,-100,-100,-100,-100,1
-63,-100,-100,-100,-72,-100,-100,-100,-100,1
-53,-83,-88,-100,-58,-100,-100,-100,-100,1
-53,-83,-88,-100,-58,-100,-100,-100,-100,1
-61,-79,-92,-84,-72,-100,-100,-100,-100,1
-55,-85,-82,-100,-71,-100,-96,-100,-100,1
-36,-78,-80,-82,-72,-100,-100,-100,-100,1
-52,-87,-75,-82,-79,-100,-97,-100,-100,1
-16,-100,-78,-100,-62,-100,-100,-100,-100,1
-40,-84,-77,-83,-76,-100,-89,-100,-100,1
-45,-100,-84,-100,-74,-100,-100,-100,-100,1
-52,-100,-82,-100,-83,-100,-96,-100,-100,1
-37,-76,-74,-100,-79,-100,-82,-100,-100,1
-36,-76,-71,-100,-75,-100,-82,-100,-100,1
-36,-79,-83,-87,-75,-100,-81,-100,-100,1
-44,-76,-77,-79,-80,-100,-85,-100,-100,1
-61,-73,-72,-89,-77,-100,-86,-100,-100,1
-59,-82,-85,-88,-100,-100,-84,-100,-100,1
-65,-68,-89,-90,-100,-100,-92,-100,-100,1
-68,-100,-86,-100,-86,-100,-87,-100,-100,1
-78,-100,-100,-92,-100,-100,-100,-100,-100,1
-58,-100,-81,-100,-78,-100,-86,-100,-100,1
-58,-74,-75,-83,-81,-100,-97,-100,-100,1
-100,-72,-65,-78,-78,-100,-100,-100,-100,1
-58,-57,-69,-77,-79,-100,-94,-100,-97,1
-52,-76,-80,-87,-82,-100,-100,-100,-100,1
-59,-75,-78,-89,-79,-100,-100,-100,-100,1
-49,-70,-74,-80,-76,-100,-100,-100,-100,1
-49,-70,-74,-80,-76,-100,-100,-100,-100,1
-49,-73,-66,-100,-79,-100,-92,-100,-97,1
-47,-80,-71,-79,-76,-100,-96,-100,-94,1
-47,-80,-71,-79,-76,-100,-96,-100,-94,1
-43,-66,-63,-100,-65,-100,-100,-100,-100,1
-50,-73,-63,-81,-65,-100,-100,-100,-100,1
-54,-67,-63,-82,-65,-100,-90,-100,-100,1
-64,-77,-64,-68,-100,-100,-71,-100,-80,0
-83,-71,-54,-69,-100,-100,-100,-89,-89,0
-83,-69,-54,-71,-100,-100,-100,-90,-100,0
-83,-70,-54,-69,-100,-100,-84,-89,-88,0
-83,-70,-54,-69,-100,-100,-100,-90,-87,0
-83,-74,-54,-79,-100,-100,-75,-79,-87,0
-82,-100,-54,-70,-100,-100,-90,-100,-89,0
-70,-73,-53,-77,-100,-100,-100,-100,-86,0
-100,-77,-71,-100,-100,-85,-91,-100,-74,0
-100,-100,-71,-85,-100,-94,-100,-100,-77,0
-100,-78,-71,-85,-100,-100,-100,-100,-77,0
-100,-78,-69,-92,-100,-93,-100,-100,-77,0
-100,-100,-70,-86,-100,-93,-100,-100,-77,0
-100,-100,-71,-86,-100,-100,-100,-100,-77,0
-100,-100,-71,-86,-100,-83,-100,-100,-77,0
-100,-82,-71,-100,-100,-95,-100,-100,-81,0
-75,-100,-68,-68,-100,-100,-100,-100,-100,1
-100,-65,-73,-68,-100,-100,-100,-100,-100,1
-68,-63,-70,-77,-100,-100,-100,-100,-100,1
-73,-47,-60,-74,-82,-86,-100,-100,-100,1
-100,-76,-53,-100,-100,-75,-100,-100,-76,0
-100,-74,-48,-100,-100,-100,-100,-100,-71,0
-71,-65,-39,-74,-100,-100,-86,-100,-70,0
-76,-66,-52,-79,-100,-100,-85,-100,-67,0
-79,-69,-42,-76,-100,-100,-100,-100,-66,0
-74,-68,-48,-100,-100,-100,-82,-82,-82,0
-67,-70,-49,-100,-100,-100,-76,-100,-76,0
-74,-52,-51,-74,-89,-100,-85,-100,-83,0
-78,-56,-49,-74,-84,-94,-84,-85,-79,0
-100,-64,-54,-100,-100,-100,-90,-100,-78,0
-83,-77,-46,-83,-100,-71,-88,-100,-78,0
-100,-67,-59,-82,-100,-100,-76,-100,-88,0
-100,-83,-56,-75,-100,-100,-69,-100,-83,0
-100,-68,-100,-83,-100,-70,-93,-100,-85,0
-100,-74,-52,-100,-100,-79,-100,-100,-74,0
-100,-100,-57,-100,-100,-81,-88,-100,-77,0
-100,-60,-60,-100,-92,-100,-85,-100,-77,0
-62,-71,-69,-81,-100,-100,-92,-83,-100,1
-55,-64,-64,-82,-78,-96,-92,-100,-91,1
-71,-67,-69,-61,-81,-92,-100,-100,-100,1
-77,-64,-69,-61,-78,-91,-94,-100,-93,1
-76,-50,-55,-65,-83,-100,-94,-100,-100,1
-100,-47,-55,-64,-83,-100,-100,-100,-100,1
-100,-48,-55,-66,-84,-100,-99,-100,-90,1
-75,-50,-55,-65,-100,-100,-94,-100,-90,1
